* תקווה כתומה - איריס חיים, אמו של יותם ז"ל, החטוף שנהרג מאש כוחותנו, פותחת חלון לתדר של תקווה, דווקא בימי שבר אישי עמוק.
* סימנים של תקווה - מורן סטלה ינאי בסיפורה המצמרר על מרגע חטיפתה, השהות בשבי החמאס ועד השיבה הביתה, דרך גדושת סימנים של תקווה.
* אלישע מדן - איש מילואים אשר 'רץ' לאש ביום השבעה באוקטובר על דעת עצמו, איבד את שתי רגליו. על האופניים מותאמים שהוכנו בעבורו ועד הנסיעה ל'הרכבת רגליים' כדבריו, בארה"ב.
* אמא של תקווה - עידית אהל, אמו של אלון החטוף בעזה בטקסט מצמרר על דרך של תקווה, מרגע תליית השלט המאולתר '...מוזמנים בחיוך ובתקווה'
* בסמיכות לקבלת הודעת החטיפה, דרך עשייה מחזקת בכל רחבי הארץ והעולם בשם התקווה, כדוגמת ‘פרויקט הפסנתרים’.
* תקווה משפחתית -משפחתו של שלומי זיו ששב מעזה בסיפור עוצמתי של אמונה, תקווה וכלים בעת משבר.
* אחדות ותקווה - חגי לובר, בימאי, מחזאי, שחקן ומנהל תיאטרון שאיבד את בנו יהונתן ומתעל את הכאב ליצירת אחדות על בסיס יומיומי.
* 'בת העוטף' - ד"ר אורנה אוריין גרה בסמיכות לעזה. ד"ר לאמנות, חוקרת, מרצה ואמנית, בטקסט נוגע על אמנות ותקווה.
* תקווה פראלימפית - יוליה צ'רנוי, קלעית וחותרת זוכת מדליות זהב ואליפות אירופה, עוצרת לחלוק סיפור מצמרר, מילדה נכה שחוותה את מהלומות
* החיים בבית יתומים נידח ועד ניצחון עצמי וגאווה לאומית בימי משבר לאומי שנחקק על בימת הנשיא.
* מחנות של תקווה - ד"ר אפרים יצחקי - ניצול השואה עם סיפור עוצמתי שזור בנקודות ורגעים של תקווה.
* פסגות של תקווה - עופר בן דור - אח שכול, איש עסקים ומנטור בינלאומי הפועל רבות לשיקום פצועי המלחמה, שמצא תקווה בגבהים. על מסעות טיפוס להרים הגבוהים בעולם לצד אנשים בעלי מוגבלויות ולקויי ראייה.
* חדשות טובות – רעות בנימין מייסדת מיזם בעל אלפי העוקבים, מציגה תקווה באמצעות חדשות טובות.
* אורות של תקווה - גיל טייכמן אמן התאורה ושותפו, חלק מהותי מציר הזמן של המדינה והתקופה, בטקסט גדוש אור.
* יועצת לנסיך אנגליה, חוקרת מוח, מחברת רבי מכר ולוחמת אש ידועה בבריטניה. סיפור עוצמתי מילדה - Dr. Sab Cohen תקווה, מגדר וניפוץ תקרות אבודה וחסרת כל לאושיה משפיעה המרבה טוב בעולם.
* חלומות ותקווה - הגברת אנה גרבר לסין - מלווה מנטלית ומטפלת של עשירי עולם, מחברת ספר עטור שבחים חולקת סיפור אישי עמוק לצד כלים של תקווה מעולם החלומות.
* אפיגנטיקה ותקווה - מהרחוב לצוות החוקר תרופה לסרטן, מפי ד"ר ליאת אדרי.
* הזכות לקוות - כלים מעולמות המשפט מאת משרד עורכי הדין אור-חוף.
* תקווה וסייבר - מר גבריאל מרכוס - מומחה סייבר בינלאומי שפועל רבות בתקופה.
* תקווה מהסרטים - בעלי סינמה סיטי מר אבי אדרי על אהבה, תקווה וכלים מהסרטים.
* תקווה יחפה - גיא פליקסברודט 'איש הברזל היחף', פעיל למען משפחות החטופים, על מסעו האישי והלאומי.
* הדהוד התקווה - ד"ר דורית רדליך חוקרת התקווה שחקרה אותה מהלך 6 שנים בקנדה.
* שי קדם - צלם האופנה הבינלאומי, איש רוח, מנטור ומורה לצילום החי על ציר ת"א-אירופה על תקווה ופוטותרפיה מסע של חיבור בין אנושיות למצלמה.
* רוקדת תקווה - לאה ינאי מור, רקדנית בינלאומית מוערכת ושופטת מלאת לב ב'רוקדים עם כוכבים'. בסיפור חיים גדוש התמודדות ותקווה לצד סיפור
* כאחות למי ששהתה בשבי החמאס.
* התקווה חוזרת ללב - תלמה אליגון-רוז במילים שזורות שנוגעות מרחל המשוררת, דרך פנדורה ועד המקורות.
* 'שורדת תקווה' - לייה גיל בטקסט מרגש וגדוש השראה על מסע בין אבדן לתקווה.
* 'תקווה אבודה' - צופית גרנט בטקסט נוגע המדבר אל כל לב.
* רפואה ותקווה - פרופ' חגי לוין – שתומך בחטופים ובשבים.
* על כמוסות של תקווה, תרופות מצילות חיים מאת ‘חברים לרפואה’.
* נתינה של תקווה - מר ג'ף סניידל - פילנתרופ יהודי שהעניק תקווה בעוצמה לחיילינו. מייסד של פרויקט בינלאומי עצום לסטודנטים בתפוצות.
* 'טיקים של תקווה' - דניאל מורס שמוצא תקווה לצד תסמונת טורט, השראה מרגשת לכל אדם.
* תקווה קיומית - פרופ' אבי שגיא על תקווה מהספרים ועד לפרקטיקת חיים גדושת משמעות.
* 'שלווה נותנים תקווה' מאת ‘להקת שלווה’, כי מי יכולים להעניק תקווה יותר מאלו המוצאים אותה בכל יום מחדש בעצמם?